R 800 500
SO ./textures/brick.xpm
NO ./textures/greystone.xpm
EA ./textures/bluestone.xpm
WE ./textures/wood.xpm
S ./textures/ghost.xpm
F 255, 40, 0
C 0, 255 ,255

1111111111111
1200100010001111
1100002200000001
1001020000000W01
1000000000001001
1011111111111111
1010000000111111
1000000020000001
1111000111111101
   1101111111101
    100000000001
    111111111111
