R 1500 1000
SO ./textures/brick.xpm
NO ./textures/greystone.xpm
EA ./textures/bluestone.xpm
WE ./textures/wood.xpm
S ./textures/pillar.xpm
F 255, 40, 0
C 0, 255 ,255

1111111111111
10001S0010001
1100002200001
1001022222001
1000000000001
1111111111111
