R 900 450
NO ./texture.xpm
SO ./texture.xpm
WE ./texture.xpm
EA ./texture.xpm
S ./texture.xpm
F 220,100,0
C 225,30,0



111     1111111111111111111111111
101     1000000000110000000000001
111     1011000001110000002000001
        1001000000000000000000001
111111111011000001110000000000001
100000000011000001110111111111111
11110111111111011100000010001                                   1111111111111111111
11110111111111011101010010001                                   1000000000000000001
11000000110101011100000010001111111111111111111111111111111111111000000000000000001
10002000000000001100000000000000000000000000000000000000000000000000000000000000001
10000000000000001101010010001111111111111111111111111111111111111000000000000000001
1100000111010101111101111000111                                 1111111111111111111
11110111 1110101 101111010N01
11111111 1111111 111111111111
