R 1500 1000
SO ./textures/brick.xpm
NO ./textures/greystone.xpm
EA ./textures/bluestone.xpm
WE ./textures/wood.xpm
S ./textures/ghost.xpm
F 255, 40, 0
C 0, 255 ,255

1111111111111
1200100010001111
1100002200000001
1001020000000W01
1000000000001001
1111111111111111
