R 1000 1000
NO ./textures/WALL33.xpm
SO ./textures/greystone.xpm
WE ./textures/bluestone.xpm
EA ./textures/colorstone.xpm
S ./textures/pillar.xpm
F 220,100,0
C 225,30,0

11111111111111111111111111111111111111111111111111111111111111111111111
10000000000000000000000000000001000000000000000000000000000000000000001
10000000000000000000000000000001000000000000000000000000000000000000001
10000000000000000000000000000001000000000000000000000000000000200002001
10000000000000000000000000000001000000000000000000000000E00001000000001
10000000000000000000000000000001000000000000000000000000000001000000001
11111111111111111111111111111111111111111111111111111111111111111111111

