R 900 500
SO ./textures/WALL33.xpm
NO ./textures/greystone.xpm
EA ./textures/bluestone.xpm
WE ./textures/colorstone.xpm
S ./textures/pillar.xpm
F 40,40,40
C 60,100,255

1111111111111
1000100010001
1100002200001
10S1020200001
1000000000001
1111111111111

