R 1500 1000
NO ./textures/WALL33.xpm
SO ./textures/greystone.xpm
WE ./textures/bluestone.xpm
EA ./textures/colorstone.xpm
S ./textures/greystone.xpm
F 220,100,0
C 225,30,0

11111111111111111111111111111111111111111111111111111111111111111111111
10000000000000000000000000000000000000000000000000000000000000000000001
10000000000000000000000000000000000000000000000000000000000000000000001
12020000000002222222222222222222222222222222222222222222222222222222221
10N00000000000000000000000000000000000000000000000000000000000000000001
10000000000000000000000000000000000000000000000000000000000000000000001
11111111111111111111111111111111111111111111111111111111111111111111111

