R 1600 700
NO ./texture.xpm
SO ./texture.xpm
WE ./texture.xpm
EA ./texture.xpm
S ./texture.xpm
F 220,100,0
C 225,30,0



111     1111111111111111111111111
101     1000000000110000000000001
111     1011000001110000002000001
        1001000000000000000000001
111111111011000001110000000000001
100000000011000001110111111111111
11110111111111011100000010001
11110111111111011101010010001
11000000110101011100000010001
10002000000000001100000010001
10000000000000001101010010001
1100N00111010101111101111000111
11110111 1110101 101111010001
11111111 1111111 111111111111
