R 1000 1000
NO ./textures/WALL33.xpm
SO ./textures/greystone.xpm
WE ./textures/bluestone.xpm
EA ./textures/colorstone.xpm
S ./textures/pillar.xpm
F 40,40,40
C 60,100,255

11111111111111111111111111111111111111111111111111111111111111111111111
10000000000000000000000000000001000000000000000000000000000000000000001
10000000000000000000000000000001000000000000000000000000000000000000001
10000000000000000000000000000001000000000000000000000000000000200002001
10000000000000000000000000000001000000000000000000000000N00001000000001
10000000000000000000000000000001000000000000000000000000000001000000001
11111111111111111111111111111111111111111111111111111111111111111111111

