R 1000 1000
SO ./textures/WALL33.xpm
NO ./textures/greystone.xpm
EA ./textures/bluestone.xpm
WE ./textures/colorstone.xpm
S ./textures/pillar.xpm
F 40,40,40
C 60,100,255

1111111111111
10001S0010001
1100002200001
1001022222001
1000000000001
1111111111111

